
int map_1[10][10] = {
{ 0,1,1,1,1,0,0,0 },
{ 0,0,1,4,1,0,0,0 },
{ 0,0,1,0,1,1,1,1 },
{ 1,1,1,0,0,2,4,1 },
{ 1,4,2,2,0,1,1,1 },
{ 1,1,1,3,2,1,0,0 },
{ 0,0,0,1,4,1,0,0 },
{ 0,0,0,1,1,1,0,0 }
};
int map_2[10][10] = {
{ 0,1,0,1,1,1,1,1,1,1 },
{ 0,0,1,0,0,0,1,0,3,1 },
{ 0,1,0,0,0,0,1,0,0,1 },
{ 0,1,0,2,0,2,0,2,0,1 },
{ 1,0,0,0,2,1,1,0,0,1 },
{ 1,0,0,0,2,0,0,0,1,1 },
{ 1,4,4,4,4,4,0,0,1,0 },
{ 1,1,1,1,1,1,1,1,1,0 },
};
int map_3[10][10] = {
{ 1,1,1,1,1,1,1,1,1,1 },
{ 1,3,0,0,0,0,0,0,1,1 },
{ 1,0,1,1,2,0,0,0,1,1 },
{ 1,0,0,2,0,0,0,1,1,1 },
{ 1,0,0,2,1,0,0,1,1,1 },
{ 1,0,2,0,0,4,0,4,0,1 },
{ 1,0,1,4,0,4,0,0,0,1 },
{ 1,1,1,1,1,1,1,1,1,1 },
};
